기준시간,개표율,개표수,윤석열_득표율,윤석열_득표수,이재명_득표율,이재명_득표수,표차
2022-03-09 21:17:00,0.3,101526,37.66,37445,59.42,59081,21636
2022-03-09 21:24:00,0.49,167718,40.21,66673,56.77,94131,27458
2022-03-09 21:25:00,0.51,174209,39.84,68603,57.16,98425,29822
2022-03-09 21:26:00,0.56,189358,40.35,75548,56.64,106039,30491
2022-03-09 21:27:00,0.58,197321,40.83,79648,56.12,109467,29819
2022-03-09 21:28:00,0.61,207564,40.88,83879,56.06,115017,31138
2022-03-09 21:29:00,0.63,215757,41.32,88130,55.63,118652,30522
2022-03-09 21:30:00,0.69,235692,42.39,98806,54.54,127115,28309
2022-03-09 21:31:00,0.73,247501,42.69,104474,54.25,132753,28279
2022-03-09 21:32:00,0.77,262014,43.05,111534,53.89,139611,28077
2022-03-09 21:33:00,0.85,288562,43.0,122704,53.96,153997,31293
2022-03-09 21:34:00,0.9,306557,43.11,130694,53.87,163314,32620
2022-03-09 21:35:00,0.98,333901,43.19,142643,53.77,177594,34951
2022-03-09 21:36:00,1.03,352114,43.42,151256,53.54,186500,35244
2022-03-09 21:37:00,1.09,370098,43.59,159613,53.36,195416,35803
2022-03-09 21:38:00,1.15,393421,43.64,169933,53.33,207643,37710
2022-03-09 21:39:00,1.23,417610,43.35,179210,53.63,221700,42490
2022-03-09 21:40:00,1.32,448872,43.75,194390,53.23,236493,42103
2022-03-09 21:41:00,1.41,480241,43.62,207356,53.36,253656,46300
2022-03-09 21:42:00,1.45,493374,43.76,213724,53.22,259935,46211
2022-03-09 21:43:00,1.54,525671,43.56,226703,53.42,278031,51328
2022-03-09 21:44:00,1.6,546677,43.36,234716,53.62,290222,55506
2022-03-09 21:45:00,1.69,574360,43.65,248237,53.33,303317,55080
2022-03-09 21:46:00,1.73,589768,43.75,255522,53.22,310827,55305
2022-03-09 21:47:00,1.8,613368,43.64,265109,53.34,324029,58920
2022-03-09 21:48:00,1.85,630573,43.6,272310,53.39,333444,61134
2022-03-09 21:49:00,1.94,661456,43.52,285119,53.45,350153,65034
2022-03-09 21:50:00,2.04,696257,43.51,299968,53.46,368602,68634
2022-03-09 21:51:00,2.09,712480,43.45,306586,53.52,377654,71068
2022-03-09 21:52:00,2.18,741453,43.87,322185,53.09,389865,67680
2022-03-09 21:53:00,2.28,776902,43.97,338339,52.99,407767,69428
2022-03-09 21:54:00,2.35,799831,43.88,347605,53.07,420397,72792
2022-03-09 21:55:00,2.45,833141,43.71,360647,53.25,439350,78703
2022-03-09 21:56:00,2.53,862398,43.71,373367,53.25,454846,81479
2022-03-09 21:57:00,2.63,894421,44.07,390395,52.88,468424,78029
2022-03-09 21:58:00,2.7,919402,44.06,401215,52.89,481591,80376
2022-03-09 21:59:00,2.78,945606,43.99,411961,52.95,495897,83936
2022-03-09 22:00:00,2.92,993892,43.93,432394,53.0,521679,89285
2022-03-09 22:01:00,3.0,1021334,44.17,446752,52.77,533728,86976
2022-03-09 22:02:00,3.1,1056379,44.36,464077,52.57,549948,85871
2022-03-09 22:03:00,3.27,1113161,44.68,492606,52.24,575953,83347
2022-03-09 22:04:00,3.35,1141530,44.71,505500,52.21,590289,84789
2022-03-09 22:05:00,3.44,1171392,44.89,520838,52.02,603558,82720
2022-03-09 22:06:00,3.56,1211874,45.2,542483,51.72,620728,78245
2022-03-09 22:07:00,3.65,1242554,45.25,556804,51.66,635696,78892
2022-03-09 22:08:00,3.78,1286652,45.1,574766,51.8,660125,85359
2022-03-09 22:09:00,3.91,1333795,45.06,595340,51.84,684892,89552
2022-03-09 22:10:00,4.04,1376530,45.15,615607,51.76,705699,90092
2022-03-09 22:11:00,4.14,1411886,45.12,631018,51.78,724105,93087
2022-03-09 22:12:00,4.3,1465600,45.41,659292,51.49,747629,88337
2022-03-09 22:13:00,4.42,1507101,45.53,679814,51.37,767052,87238
2022-03-09 22:14:00,4.56,1552231,45.6,701270,51.28,788593,87323
2022-03-09 22:15:00,4.7,1601470,45.43,720862,51.45,816322,95460
2022-03-09 22:16:00,4.82,1642868,45.68,743501,51.2,833428,89927
2022-03-09 22:17:00,4.98,1698329,45.64,767812,51.24,862151,94339
2022-03-09 22:18:00,5.05,1719960,45.68,778292,51.2,872414,94122
2022-03-09 22:19:00,5.24,1785601,45.55,805753,51.33,907872,102119
2022-03-09 22:20:00,5.36,1826905,45.46,822650,51.43,930696,108046
2022-03-09 22:21:00,5.45,1856786,45.49,836754,51.39,945206,108452
2022-03-09 22:22:00,5.61,1912968,45.62,864428,51.25,971179,106751
2022-03-09 22:23:00,5.82,1983227,45.7,897853,51.16,1005142,107289
2022-03-09 22:24:00,5.96,2031259,45.75,920696,51.1,1028251,107555
2022-03-09 22:25:00,6.08,2071838,45.84,940859,51.02,1047118,106259
2022-03-09 22:26:00,6.26,2132615,45.94,970572,50.91,1075672,105100
2022-03-09 22:27:00,6.36,2168261,45.93,986659,50.91,1093652,106993
2022-03-09 22:28:00,6.56,2236539,46.07,1020846,50.78,1125062,104216
2022-03-09 22:29:00,6.66,2268281,46.04,1034764,50.8,1141558,106794
2022-03-09 22:30:00,6.84,2330866,46.2,1066992,50.64,1169464,102472
2022-03-09 22:31:00,7.06,2405489,46.24,1102102,50.6,1206090,103988
2022-03-09 22:32:00,7.19,2448515,46.29,1122984,50.55,1226411,103427
2022-03-09 22:33:00,7.39,2518368,46.4,1157828,50.44,1258626,100798
2022-03-09 22:33:00,7.53,2567165,46.47,1182246,50.35,1280951,98705
2022-03-09 22:35:00,7.71,2627091,46.54,1201893,50.28,1298442,96549
2022-03-09 22:35:00,7.79,2653265,46.5,1222441,50.32,1323099,100658
2022-03-09 22:36:00,7.87,2679897,46.54,1235837,50.27,1334981,99144
2022-03-09 22:36:00,8.01,2728926,46.63,1260803,50.19,1357124,96321
2022-03-09 22:37:00,8.15,2778405,46.68,1285165,50.13,1380036,94871
2022-03-09 22:37:00,8.21,2795972,46.68,1293219,50.13,1388704,95485
2022-03-09 22:38:00,8.29,2822969,46.72,1306929,50.08,1400710,93781
2022-03-09 22:38:00,8.44,2875032,46.73,1331340,50.07,1426353,95013
2022-03-09 22:39:00,8.55,2914720,46.7,1348612,50.11,1447126,98514
2022-03-09 22:39:00,8.7,2963307,46.65,1369888,50.15,1472500,102612
2022-03-09 22:40:00,8.81,3001721,46.66,1378298,50.14,1480993,102695
2022-03-09 22:40:00,8.86,3018259,46.69,1396533,50.1,1498457,101924
2022-03-09 22:41:00,8.94,3046437,46.75,1411360,50.04,1510645,99285
2022-03-09 22:41:00,9.05,3083794,46.69,1426696,50.11,1531099,104403
2022-03-09 22:42:00,9.16,3120165,46.68,1443266,50.12,1549550,106284
2022-03-09 22:42:00,9.34,3182726,46.66,1471651,50.13,1581228,109577
2022-03-09 22:43:00,9.4,3201728,46.7,1481573,50.1,1589487,107914
2022-03-09 22:43:00,9.56,3257618,46.64,1505566,50.17,1619510,113944
2022-03-09 22:44:00,9.7,3304266,46.68,1528747,50.12,1641239,112492
2022-03-09 22:44:00,9.81,3342168,46.68,1546112,50.12,1660172,114060
2022-03-09 22:45:00,9.91,3376452,46.77,1565117,50.03,1674051,108934
2022-03-09 22:45:00,9.98,3401860,46.74,1575891,50.06,1687708,111817
2022-03-09 22:46:00,10.24,3489607,46.71,1615465,50.09,1732336,116871
2022-03-09 22:46:00,10.28,3503854,46.7,1621810,50.1,1739734,117924
2022-03-09 22:47:00,10.55,3592831,46.55,1657731,50.25,1789402,131671
2022-03-09 22:47:00,10.67,3634501,46.6,1678768,50.2,1808359,129591
2022-03-09 22:48:00,10.85,3698261,46.6,1708222,50.2,1840200,131978
2022-03-09 22:48:00,11.0,3749361,46.6,1731918,50.2,1865636,133718
2022-03-09 22:49:00,11.03,3759107,46.62,1737005,50.18,1869922,132917
2022-03-09 22:49:00,11.15,3797747,46.64,1755911,50.16,1888150,132239
2022-03-09 22:50:00,11.26,3835214,46.64,1773305,50.15,1906695,133390
2022-03-09 22:50:00,11.47,3906411,46.53,1801978,50.26,1946405,144427
2022-03-09 22:51:00,11.57,3941918,46.5,1816986,50.3,1965525,148539
2022-03-09 22:51:00,11.74,4000223,46.57,1846975,50.22,1991615,144640
2022-03-09 22:52:00,11.88,4048609,46.47,1865249,50.33,2019962,154713
2022-03-09 22:52:00,12.08,4116772,46.56,1900069,50.24,2050396,150327
2022-03-09 22:53:00,12.11,4126004,46.59,1905459,50.21,2053796,148337
2022-03-09 22:53:00,12.29,4187522,46.64,1936423,50.16,2082147,145724
2022-03-09 22:54:00,12.46,4245780,46.68,1965073,50.11,2109266,144193
2022-03-09 22:54:00,12.62,4299582,46.68,1989828,50.11,2136095,146267
2022-03-09 22:54:00,12.65,4309182,46.67,1993735,50.13,2141536,147801
2022-03-09 22:55:00,12.76,4347972,46.69,2012708,50.1,2159445,146737
2022-03-09 22:56:00,12.85,4379530,46.71,2027936,50.08,2174546,146610
2022-03-09 22:56:00,13.09,4460244,46.64,2062464,50.15,2217645,155181
2022-03-09 22:57:00,13.22,4502787,46.68,2083690,50.11,2237137,153447
2022-03-09 22:57:00,13.3,4532791,46.68,2097863,50.1,2251638,153775
2022-03-09 22:57:00,13.41,4570528,46.68,2115279,50.1,2270357,155078
2022-03-09 22:58:00,13.54,4614238,46.66,2134766,50.12,2292837,158071
2022-03-09 22:59:00,13.65,4651218,46.67,2152106,50.11,2310983,158877
2022-03-09 22:59:00,13.91,4738852,46.63,2190955,50.15,2356268,165313
2022-03-09 22:59:00,14.0,4770972,46.61,2204707,50.17,2373402,168695
2022-03-09 23:00:00,14.15,4819733,46.67,2230273,50.11,2394635,164362
2022-03-09 23:01:00,14.34,4885658,46.61,2257764,50.18,2430666,172902
2022-03-09 23:01:00,14.5,4938866,46.59,2281455,50.2,2458101,176646
2022-03-09 23:01:00,14.65,4991821,46.55,2304183,50.23,2486362,182179
2022-03-09 23:02:00,14.72,5014987,46.58,2316213,50.21,2496530,180317
2022-03-09 23:02:00,14.87,5067480,46.53,2338100,50.26,2525228,187128
2022-03-09 23:03:00,14.97,5099203,46.55,2353822,50.24,2540167,186345
2022-03-09 23:03:00,15.11,5148636,46.5,2374073,50.29,2567296,193223
2022-03-09 23:04:00,15.45,5262861,46.66,2434788,50.14,2616435,181647
2022-03-09 23:04:00,15.63,5324354,46.61,2460700,50.19,2649710,189010
2022-03-09 23:05:00,15.8,5383361,46.63,2489269,50.16,2677630,188361
2022-03-09 23:05:00,15.91,5421602,46.62,2506502,50.17,2697033,190531
2022-03-09 23:06:00,16.13,5495947,46.63,2541551,50.15,2733413,191862
2022-03-09 23:06:00,16.23,5529794,46.67,2559073,50.12,2748261,189188
2022-03-09 23:07:00,16.43,5598424,46.73,2594400,50.05,2778734,184334
2022-03-09 23:07:00,16.6,5655699,46.73,2620741,50.06,2807309,186568
2022-03-09 23:08:00,16.8,5724465,46.81,2657427,49.97,2836686,179259
2022-03-09 23:08:00,16.89,5753711,46.81,2670941,49.97,2851236,180295
2022-03-09 23:09:00,17.08,5820212,46.83,2702860,49.95,2883220,180360
2022-03-09 23:09:00,17.27,5885459,46.82,2732823,49.96,2915864,183041
2022-03-09 23:10:00,17.45,5945423,46.84,2761509,49.94,2944802,183293
2022-03-09 23:10:00,17.68,6025496,46.87,2800984,49.9,2982042,181058
2022-03-09 23:11:00,17.76,6049731,46.86,2811545,49.92,2994668,183123
2022-03-09 23:11:00,17.96,6118548,46.86,2843164,49.92,3029173,186009
2022-03-09 23:12:00,18.18,6194000,46.88,2879387,49.9,3065303,185916
2022-03-09 23:12:00,18.32,6242538,46.84,2899623,49.94,3091629,192006
2022-03-09 23:13:00,18.49,6300622,46.81,2924800,49.97,3122429,197629
2022-03-09 23:13:00,18.57,6326022,46.79,2935122,50.0,3136625,201503
2022-03-09 23:14:00,18.84,6420548,46.81,2980642,49.97,3181627,200985
2022-03-09 23:14:00,19.05,6491791,46.86,3016627,49.92,3213574,196947
2022-03-09 23:15:00,19.16,6528939,46.86,3033871,49.92,3232038,198167
2022-03-09 23:15:00,19.39,6607135,46.86,3070744,49.91,3270342,199598
2022-03-09 23:16:00,19.66,6697297,46.85,3111515,49.92,3315788,204273
2022-03-09 23:16:00,19.76,6734071,46.86,3129286,49.91,3333396,204110
2022-03-09 23:16:00,19.96,6800524,46.87,3161010,49.9,3365537,204527
2022-03-09 23:17:00,20.23,6891206,46.89,3204637,49.88,3408963,204326
2022-03-09 23:18:00,20.48,6979036,46.92,3247371,49.85,3450583,203212
2022-03-09 23:18:00,20.7,7052554,46.9,3280781,49.86,3487585,206804
2022-03-09 23:19:00,20.86,7108555,46.94,3309188,49.83,3512726,203538
2022-03-09 23:19:00,20.93,7130824,46.94,3319578,49.82,3523657,204079
2022-03-09 23:19:00,21.01,7157968,46.91,3330211,49.85,3539065,208854
2022-03-09 23:20:00,21.29,7252217,46.87,3371406,49.89,3588147,216741
2022-03-09 23:21:00,21.49,7320462,46.87,3402692,49.89,3622360,219668
2022-03-09 23:21:00,21.67,7383516,46.96,3438527,49.8,3646907,208380
2022-03-09 23:21:00,21.77,7416431,46.96,3453685,49.81,3663252,209567
2022-03-09 23:22:00,22.03,7504429,46.94,3493414,49.82,3707961,214547
2022-03-09 23:23:00,22.26,7584959,46.83,3522828,49.93,3755829,233001
2022-03-09 23:23:00,22.54,7679131,46.83,3566632,49.93,3802523,235891
2022-03-09 23:23:00,22.67,7724011,46.84,3587974,49.92,3824208,236234
2022-03-09 23:24:00,22.85,7785834,46.86,3618707,49.89,3852544,233837
2022-03-09 23:24:00,22.98,7828063,46.89,3640098,49.87,3871469,231371
2022-03-09 23:25:00,23.25,7921591,46.91,3685180,49.85,3916098,230918
2022-03-09 23:25:00,23.52,8015289,46.88,3726535,49.88,3965409,238874
2022-03-09 23:26:00,23.78,8103730,46.88,3767929,49.88,4008822,240893
2022-03-09 23:26:00,24.04,8192261,46.86,3807140,49.9,4054509,247369
2022-03-09 23:27:00,24.12,8218117,46.87,3820091,49.89,4066092,246001
2022-03-09 23:27:00,24.33,8289707,46.88,3854146,49.88,4100929,246783
2022-03-09 23:59:00,37.4,12741676,47.81,6041197,48.85,6173467,132270
2022-03-10 00:00:00,37.8,12877724,47.81,6106783,48.84,6237968,131185
2022-03-10 00:00:00,37.93,12922682,47.83,6130682,48.82,6256853,126171
2022-03-10 00:01:00,38.12,12988049,47.85,6163152,48.81,6286974,123822
2022-03-10 00:01:00,38.32,13054904,47.87,6198267,48.78,6315637,117370
2022-03-10 00:02:00,38.56,13137473,47.92,6243189,48.73,6349471,106282
2022-03-10 00:02:00,38.68,13178546,47.93,6263893,48.72,6368056,104163
2022-03-10 00:03:00,38.86,13238876,47.93,6293673,48.71,6395650,101977
2022-03-10 00:03:00,39.12,13327712,47.92,6334319,48.72,6440314,105995
2022-03-10 00:04:00,39.34,13404488,47.95,6375162,48.69,6472696,97534
2022-03-10 00:04:00,39.51,13460436,47.95,6401114,48.69,6500139,99025
2022-03-10 00:05:00,39.66,13511149,47.96,6426537,48.68,6523595,97058
2022-03-10 00:05:00,39.77,13549729,47.97,6446195,48.67,6540832,94637
2022-03-10 00:05:00,39.87,13583785,47.98,6463493,48.66,6556054,92561
2022-03-10 00:06:00,40.0,13627082,47.99,6485638,48.65,6575501,89863
2022-03-10 00:06:00,40.23,13707151,48.0,6525394,48.64,6612595,87201
2022-03-10 00:07:00,40.51,13801544,48.03,6574418,48.61,6654099,79681
2022-03-10 00:07:00,40.76,13888839,48.02,6615179,48.62,6696739,81560
2022-03-10 00:07:00,40.84,13913986,48.04,6629587,48.6,6706261,76674
2022-03-10 00:08:00,40.95,13953847,48.05,6649349,48.59,6724518,75169
2022-03-10 00:08:00,41.05,13987637,48.05,6665998,48.59,6739952,73954
2022-03-10 00:08:00,41.13,14012534,48.07,6679794,48.57,6749873,70079
2022-03-10 00:09:00,41.26,14058391,48.04,6698327,48.59,6775254,76927
2022-03-10 00:09:00,41.56,14158887,48.02,6743851,48.61,6826472,82621
2022-03-10 00:09:00,41.64,14186548,48.03,6757957,48.61,6838823,80866
2022-03-10 00:10:00,41.75,14224657,48.04,6777122,48.6,6856028,78906
2022-03-10 00:10:00,41.83,14250636,48.05,6790989,48.59,6866735,75746
2022-03-10 00:10:00,41.92,14284330,48.06,6808022,48.58,6881887,73865
2022-03-10 00:10:00,42.01,14312836,48.07,6823150,48.57,6893956,70806
2022-03-10 00:11:00,42.11,14345886,48.06,6837602,48.58,6911160,73558
2022-03-10 00:11:00,42.36,14433475,48.03,6875908,48.6,6956781,80873
2022-03-10 00:12:00,42.53,14490965,48.06,6907325,48.57,6980474,73149
2022-03-10 00:12:00,42.61,14516282,48.07,6919934,48.57,6991889,71955
2022-03-10 00:12:00,42.68,14542584,48.08,6933935,48.56,7003019,69084
2022-03-10 00:12:00,42.8,14580963,48.08,6952987,48.55,7020569,67582
2022-03-10 00:13:00,42.95,14634315,48.08,6977475,48.56,7047376,69901
2022-03-10 00:13:00,43.07,14674040,48.09,6997877,48.55,7064910,67033
2022-03-10 00:14:00,43.32,14760659,48.09,7039605,48.54,7106243,66638
2022-03-10 00:14:00,43.44,14800809,48.09,7058651,48.54,7125509,66858
2022-03-10 00:14:00,43.79,14919286,48.09,7114929,48.54,7182420,67491
2022-03-10 00:15:00,43.85,14941349,48.09,7126355,48.53,7191949,65594
2022-03-10 00:15:00,44.03,15000115,48.1,7155396,48.53,7219030,63634
2022-03-10 00:15:00,44.1,15027079,48.1,7168001,48.53,7232015,64014
2022-03-10 00:16:00,44.31,15096700,48.11,7202829,48.51,7263630,60801
2022-03-10 00:17:00,44.55,15179262,48.11,7243103,48.5,7301907,58804
2022-03-10 00:17:00,44.76,15249175,48.1,7274382,48.52,7337014,62632
2022-03-10 00:18:00,44.92,15304333,48.1,7301199,48.51,7362814,61615
2022-03-10 00:18:00,45.1,15365966,48.06,7324289,48.55,7398819,74530
2022-03-10 00:18:00,45.3,15435642,48.05,7355227,48.57,7434386,79159
2022-03-10 00:19:00,45.56,15524289,48.08,7402550,48.53,7471653,69103
2022-03-10 00:19:00,45.79,15599856,48.08,7437854,48.53,7508497,70643
2022-03-10 00:20:00,46.1,15705515,48.07,7487738,48.53,7559268,71530
2022-03-10 00:20:00,46.33,15784705,48.08,7525567,48.53,7597506,71939
2022-03-10 00:21:00,46.42,15817304,48.08,7541765,48.53,7612321,70556
2022-03-10 00:21:00,46.62,15884312,48.09,7575451,48.52,7642574,67123
2022-03-10 00:22:00,46.84,15958531,48.1,7612976,48.5,7675935,62959
2022-03-10 00:22:00,47.08,16040297,48.1,7650938,48.51,7715709,64771
2022-03-10 00:23:00,47.26,16103694,48.12,7685066,48.48,7742397,57331
2022-03-10 00:23:00,47.57,16208040,48.15,7739944,48.45,7786897,46953
2022-03-10 00:24:00,47.63,16229478,48.17,7752328,48.43,7794876,42548
2022-03-10 00:24:00,47.84,16300664,48.19,7790339,48.41,7824785,34446
2022-03-10 00:25:00,48.03,16363156,48.2,7821150,48.4,7853562,32412
2022-03-10 00:25:00,48.19,16420348,48.2,7849054,48.39,7880303,31249
2022-03-10 00:26:00,48.37,16481508,48.19,7876218,48.41,7911822,35604
2022-03-10 00:26:00,48.56,16546465,48.18,7906438,48.41,7943495,37057
2022-03-10 00:26:00,48.74,16605058,48.2,7937125,48.39,7968652,31527
2022-03-10 00:27:00,48.94,16673679,48.2,7969404,48.4,8002105,32701
2022-03-10 00:28:00,49.25,16781811,48.2,8020997,48.4,8054238,33241
2022-03-10 00:28:00,49.5,16864256,48.21,8061885,48.39,8092099,30214
2022-03-10 00:29:00,49.73,16944371,48.23,8104022,48.36,8126073,22051
2022-03-10 00:29:00,49.8,16968336,48.24,8117259,48.35,8135586,18327
2022-03-10 00:29:00,49.95,17019041,48.26,8144484,48.33,8156814,12330
2022-03-10 00:30:00,50.35,17155887,48.29,8214593,48.3,8217539,2946
2022-03-10 00:31:00,50.59,17236785,48.3,8255367,48.29,8253787,1580
2022-03-10 00:31:00,50.79,17305948,48.28,8285996,48.3,8289315,3319
2022-03-10 00:31:00,50.89,17339728,48.29,8304006,48.29,8303479,527
2022-03-10 00:32:00,51.04,17391452,48.32,8333063,48.26,8323601,9462
2022-03-10 00:32:00,51.23,17455421,48.32,8363752,48.26,8354360,9392
2022-03-10 00:33:00,51.42,17521124,48.33,8397301,48.25,8383281,14020
2022-03-10 00:33:00,51.49,17544705,48.33,8408864,48.25,8394201,14663
2022-03-10 00:34:00,51.84,17663890,48.35,8468140,48.23,8448641,19499
2022-03-10 00:34:00,52.11,17754104,48.35,8511794,48.23,8491163,20631
2022-03-10 00:35:00,52.2,17786111,48.35,8527388,48.23,8506148,21240
2022-03-10 00:35:00,52.41,17855735,48.35,8561643,48.22,8538282,23361
2022-03-10 00:36:00,52.59,17917478,48.38,8595099,48.2,8563338,31761
2022-03-10 00:36:00,52.84,18004508,48.37,8636452,48.2,8604773,31679
2022-03-10 00:37:00,53.0,18058667,48.39,8664472,48.18,8628193,36279
2022-03-10 00:37:00,53.24,18138026,48.41,8706918,48.16,8661262,45656
2022-03-10 00:38:00,53.37,18182889,48.41,8728049,48.16,8682984,45065
2022-03-10 00:38:00,53.59,18259841,48.4,8762966,48.17,8721182,41784
2022-03-10 00:39:00,53.81,18333312,48.4,8798812,48.16,8755306,43506
2022-03-10 00:39:00,53.98,18393050,48.41,8829764,48.15,8781059,48705
2022-03-10 00:40:00,54.09,18428348,48.42,8847415,48.14,8797194,50221
2022-03-10 00:40:00,54.25,18483937,48.41,8873180,48.15,8824287,48893
2022-03-10 00:40:00,54.47,18558281,48.41,8908863,48.15,8859739,49124
2022-03-10 00:41:00,54.77,18660167,48.43,8961180,48.13,8904734,56446
2022-03-10 00:42:00,54.99,18735717,48.42,8995436,48.14,8942660,52776
2022-03-10 00:42:00,55.28,18834195,48.43,9044295,48.13,8988067,56228
2022-03-10 00:43:00,55.57,18932161,48.44,9094313,48.11,9031793,62520
2022-03-10 00:43:00,55.67,18966147,48.44,9109963,48.11,9048580,61383
2022-03-10 00:44:00,55.91,19049937,48.43,9148079,48.12,9090210,57869
2022-03-10 00:44:00,56.16,19133846,48.44,9190825,48.11,9127244,63581
2022-03-10 00:45:00,56.45,19232525,48.43,9236904,48.11,9175904,61000
2022-03-10 00:45:00,56.64,19297074,48.43,9266783,48.12,9207749,59034
2022-03-10 00:45:00,56.75,19336674,48.44,9288783,48.1,9223380,65403
2022-03-10 00:46:00,57.01,19423007,48.43,9327238,48.12,9267459,59779
2022-03-10 00:47:00,57.21,19493456,48.44,9363061,48.11,9298864,64197
2022-03-10 00:47:00,57.48,19584486,48.44,9407729,48.1,9340902,66827
2022-03-10 00:47:00,57.58,19619562,48.44,9424011,48.1,9358068,65943
2022-03-10 00:48:00,57.79,19689136,48.42,9453484,48.12,9394968,58516
2022-03-10 00:48:00,58.01,19764723,48.44,9494162,48.1,9426463,67699
2022-03-10 00:49:00,58.12,19801219,48.44,9510873,48.1,9444601,66272
2022-03-10 00:49:00,58.3,19863726,48.46,9544018,48.08,9470927,73091
2022-03-10 00:50:00,58.54,19946780,48.46,9584976,48.08,9509002,75974
2022-03-10 00:50:00,58.79,20029521,48.47,9626591,48.07,9546199,80392
2022-03-10 00:51:00,59.04,20115124,48.48,9669540,48.05,9584598,84942
2022-03-10 00:51:00,59.14,20150888,48.48,9687403,48.05,9600684,86719
2022-03-10 00:52:00,59.37,20227604,48.48,9723987,48.05,9637110,86877
2022-03-10 00:52:00,59.67,20331679,48.49,9774729,48.04,9685715,89014
2022-03-10 00:53:00,60.03,20451440,48.48,9831488,48.05,9743581,87907
2022-03-10 00:53:00,60.21,20513656,48.5,9864088,48.04,9770670,93418
2022-03-10 00:54:00,60.3,20546191,48.51,9882219,48.02,9783443,98776
2022-03-10 00:54:00,60.5,20611679,48.51,9913068,48.02,9814821,98247
2022-03-10 00:55:00,60.76,20700666,48.5,9954148,48.03,9858459,95689
2022-03-10 00:55:00,60.94,20763088,48.5,9984838,48.03,9886957,97881
2022-03-10 00:56:00,61.06,20805457,48.51,10006318,48.02,9905688,100630
2022-03-10 00:56:00,61.34,20897917,48.51,10051730,48.01,9948525,103205
2022-03-10 00:56:00,61.48,20946749,48.51,10074779,48.01,9972151,102628
2022-03-10 00:57:00,61.73,21033358,48.53,10121315,47.99,10008069,113246
2022-03-10 00:58:00,61.98,21118598,48.53,10161162,47.99,10049578,111584
2022-03-10 00:58:00,62.15,21173731,48.52,10186432,48.0,10076947,109485
2022-03-10 00:59:00,62.49,21289935,48.52,10242270,48.0,10131729,110541
2022-03-10 00:59:00,62.59,21323598,48.52,10258790,48.0,10147355,111435
2022-03-10 00:59:00,62.67,21352752,48.52,10272805,47.99,10161171,111634
2022-03-10 01:00:00,63.0,21465140,48.53,10328190,47.99,10212886,115304
2022-03-10 01:01:00,63.31,21570743,48.52,10376604,48.0,10265143,111461
2022-03-10 01:01:00,63.53,21646909,48.51,10412324,48.0,10302312,110012
2022-03-10 01:02:00,63.77,21727800,48.52,10453290,47.99,10338555,114735
2022-03-10 01:02:00,63.84,21752584,48.52,10465429,47.99,10349981,115448
2022-03-10 01:03:00,64.12,21847908,48.52,10510849,47.99,10395568,115281
2022-03-10 01:03:00,64.28,21901514,48.52,10536105,47.99,10421424,114681
2022-03-10 01:03:00,64.42,21948042,48.51,10557443,48.0,10444546,112897
2022-03-10 01:04:00,64.69,22042358,48.5,10600537,48.01,10491671,108866
2022-03-10 01:04:00,64.75,22060493,48.51,10610202,48.0,10499174,111028
2022-03-10 01:05:00,64.85,22096569,48.52,10629948,47.99,10513758,116190
2022-03-10 01:05:00,65.11,22183701,48.54,10676700,47.97,10549970,126730
2022-03-10 01:06:00,65.27,22237702,48.54,10702959,47.96,10575187,127772
2022-03-10 01:06:00,65.44,22295261,48.55,10732067,47.96,10600681,131386
2022-03-10 01:07:00,65.66,22372655,48.56,10771569,47.94,10634880,136689
2022-03-10 01:07:00,65.83,22430823,48.57,10801880,47.93,10660134,141746
2022-03-10 01:08:00,65.9,22453620,48.57,10813157,47.93,10670495,142662
2022-03-10 01:08:00,66.13,22531664,48.57,10850300,47.93,10707782,142518
2022-03-10 01:09:00,66.36,22609349,48.57,10887896,47.93,10744391,143505
2022-03-10 01:09:00,66.6,22690994,48.6,10933413,47.9,10776799,156614
2022-03-10 01:10:00,66.82,22765885,48.62,10974832,47.88,10806644,168188
2022-03-10 01:10:00,66.88,22785294,48.62,10983456,47.88,10816520,166936
2022-03-10 01:11:00,67.07,22852480,48.63,11018211,47.87,10845708,172503
2022-03-10 01:11:00,67.35,22947024,48.61,11057971,47.89,10896219,161752
2022-03-10 01:12:00,67.61,23037343,48.58,11096368,47.92,10944099,152269
2022-03-10 01:12:00,67.79,23097971,48.6,11129127,47.9,10968985,160142
2022-03-10 01:13:00,67.91,23136454,48.6,11148545,47.89,10986182,162363
2022-03-10 01:13:00,68.09,23197883,48.59,11175277,47.91,11018375,156902
2022-03-10 01:14:00,68.12,23211035,48.59,11182135,47.9,11023941,158194
2022-03-10 01:14:00,68.41,23309792,48.61,11233351,47.89,11066993,166358
2022-03-10 01:15:00,68.6,23374341,48.61,11265970,47.88,11095602,170368
2022-03-10 01:15:00,68.77,23431168,48.61,11293246,47.88,11122592,170654
2022-03-10 01:16:00,68.98,23501342,48.62,11327866,47.88,11154802,173064
2022-03-10 01:16:00,69.02,23515754,48.63,11336557,47.87,11159807,176750
2022-03-10 01:17:00,69.31,23615114,48.63,11384793,47.86,11205922,178871
2022-03-10 01:17:00,69.46,23666356,48.63,11410099,47.86,11229539,180560
2022-03-10 01:18:00,69.76,23767443,48.65,11463634,47.84,11271855,191779
2022-03-10 01:18:00,69.91,23820474,48.65,11489035,47.84,11297067,191968
2022-03-10 01:18:00,69.99,23847490,48.65,11501907,47.84,11309800,192107
2022-03-10 01:19:00,70.14,23897770,48.66,11529305,47.82,11330140,199165
2022-03-10 01:19:00,70.29,23948625,48.68,11557335,47.81,11350531,206804
2022-03-10 01:20:00,70.59,24050545,48.68,11607507,47.8,11397335,210172
2022-03-10 01:21:00,70.74,24102417,48.68,11632326,47.8,11421866,210460
2022-03-10 01:21:00,70.85,24141196,48.69,11651962,47.8,11439304,212658
2022-03-10 01:21:00,71.06,24210752,48.68,11683540,47.8,11474059,209481
2022-03-10 01:22:00,71.3,24293220,48.66,11718915,47.82,11517585,201330
2022-03-10 01:22:00,71.47,24351824,48.66,11748626,47.81,11543472,205154
2022-03-10 01:23:00,71.78,24456252,48.67,11799780,47.81,11591518,208262
2022-03-10 01:23:00,71.97,24522865,48.66,11830887,47.81,11623918,206969
2022-03-10 01:24:00,72.12,24573322,48.65,11851635,47.83,11651432,200203
2022-03-10 01:24:00,72.27,24621879,48.67,11879047,47.81,11670274,208773
2022-03-10 01:25:00,72.53,24713589,48.65,11919737,47.82,11717307,202430
2022-03-10 01:25:00,72.7,24769832,48.66,11948578,47.82,11742066,206512
2022-03-10 01:26:00,72.85,24819786,48.66,11974243,47.81,11763916,210327
2022-03-10 01:26:00,73.02,24880065,48.66,12002776,47.81,11792889,209887
2022-03-10 01:27:00,73.08,24900936,48.66,12013137,47.81,11802458,210679
2022-03-10 01:27:00,73.31,24976860,48.68,12054374,47.79,11833401,220973
2022-03-10 01:28:00,73.37,24998222,48.68,12064716,47.79,11843342,221374
2022-03-10 01:28:00,73.55,25060272,48.69,12095487,47.78,11871292,224195
2022-03-10 01:29:00,73.75,25129002,48.67,12123648,47.8,11909045,214603
2022-03-10 01:29:00,74.01,25216738,48.65,12161066,47.82,11954861,206205
2022-03-10 01:30:00,74.22,25286324,48.64,12192532,47.83,11989553,202979
2022-03-10 01:30:00,74.29,25311230,48.64,12205417,47.83,12000308,205109
2022-03-10 01:31:00,74.49,25379642,48.65,12239622,47.82,12031268,208354
2022-03-10 01:31:00,74.7,25450539,48.65,12274785,47.81,12063415,211370
2022-03-10 01:32:00,74.85,25503538,48.65,12299742,47.82,12088934,210808
2022-03-10 01:32:00,74.94,25532067,48.65,12314194,47.81,12101865,212329
2022-03-10 01:32:00,75.12,25595545,48.65,12344581,47.81,12131919,212662
2022-03-10 01:33:00,75.33,25665190,48.65,12377123,47.82,12165785,211338
2022-03-10 01:34:00,75.5,25723507,48.65,12406971,47.81,12191489,215482
2022-03-10 01:34:00,75.65,25775955,48.66,12433317,47.81,12215259,218058
2022-03-10 01:35:00,75.81,25828457,48.67,12461172,47.8,12237529,223643
2022-03-10 01:35:00,75.87,25850029,48.67,12472930,47.79,12246317,226613
2022-03-10 01:35:00,75.93,25869398,48.67,12482060,47.79,12255572,226488
2022-03-10 01:36:00,76.12,25933939,48.68,12515003,47.78,12284028,230975
2022-03-10 01:36:00,76.2,25963401,48.69,12530518,47.78,12296467,234051
2022-03-10 01:37:00,76.34,26008428,48.69,12553075,47.77,12316605,236470
2022-03-10 01:37:00,76.49,26062546,48.7,12581787,47.76,12339399,242388
2022-03-10 01:38:00,76.63,26107659,48.7,12603968,47.76,12360183,243785
2022-03-10 01:38:00,76.82,26172528,48.7,12635055,47.76,12391073,243982
2022-03-10 01:39:00,77.0,26235855,48.71,12667105,47.75,12419228,247877
2022-03-10 01:39:00,77.11,26272039,48.71,12685860,47.75,12434950,250910
2022-03-10 01:40:00,77.36,26358051,48.7,12724046,47.76,12478507,245539
2022-03-10 01:40:00,77.56,26425421,48.69,12755104,47.76,12511734,243370
2022-03-10 01:41:00,77.6,26440149,48.7,12763437,47.76,12517390,246047
2022-03-10 01:41:00,77.75,26489796,48.7,12788019,47.76,12539960,248059
2022-03-10 01:42:00,77.9,26540602,48.7,12813652,47.75,12562611,251041
2022-03-10 01:42:00,78.15,26626134,48.69,12850806,47.76,12606964,243842
2022-03-10 01:43:00,78.29,26673541,48.69,12875114,47.76,12627600,247514
2022-03-10 01:43:00,78.51,26749832,48.7,12914500,47.75,12661157,253343
2022-03-10 01:44:00,78.59,26775679,48.7,12926627,47.75,12673867,252760
2022-03-10 01:44:00,78.66,26800261,48.69,12936452,47.76,12687417,249035
2022-03-10 01:45:00,78.79,26845575,48.7,12958850,47.76,12708229,250621
2022-03-10 01:45:00,78.95,26899167,48.7,12986415,47.75,12731727,254688
2022-03-10 01:46:00,79.05,26934340,48.71,13004451,47.74,12747113,257338
2022-03-10 01:46:00,79.21,26988444,48.7,13029126,47.75,12774107,255019
2022-03-10 01:46:00,79.24,26999623,48.7,13034776,47.75,12779093,255683
2022-03-10 01:47:00,79.38,27047136,48.7,13057718,47.75,12801305,256413
2022-03-10 01:48:00,79.56,27106079,48.71,13088139,47.74,12826938,261201
2022-03-10 01:48:00,79.64,27135711,48.71,13101967,47.74,12841241,260726
2022-03-10 01:49:00,79.81,27191974,48.69,13124044,47.76,12872971,251073
2022-03-10 01:49:00,79.92,27231122,48.69,13143542,47.75,12890634,252908
2022-03-10 01:49:00,80.02,27264412,48.7,13161135,47.75,12904763,256372
2022-03-10 01:50:00,80.18,27319830,48.69,13186337,47.75,12931883,254454
2022-03-10 01:51:00,80.34,27373304,48.7,13213165,47.75,12955892,257273
2022-03-10 01:51:00,80.48,27420187,48.7,13236359,47.75,12977462,258897
2022-03-10 01:51:00,80.53,27436966,48.7,13244795,47.74,12984799,259996
2022-03-10 01:52:00,80.72,27501884,48.7,13275073,47.75,13016069,259004
2022-03-10 01:53:00,80.84,27542656,48.7,13294798,47.74,13034959,259839
2022-03-10 01:53:00,80.87,27552454,48.7,13299435,47.74,13039514,259921
2022-03-10 01:53:00,81.04,27611818,48.69,13325708,47.75,13069766,255942
2022-03-10 01:54:00,81.17,27656115,48.69,13347327,47.75,13090252,257075
2022-03-10 01:54:00,81.34,27712933,48.68,13372214,47.76,13119403,252811
2022-03-10 01:55:00,81.4,27732877,48.68,13381161,47.76,13129539,251622
2022-03-10 01:55:00,81.5,27769055,48.68,13399627,47.76,13145376,254251
2022-03-10 01:56:00,81.63,27813148,48.68,13421039,47.76,13166086,254953
2022-03-10 01:56:00,81.76,27855804,48.68,13441797,47.75,13185929,255868
2022-03-10 01:57:00,81.95,27922412,48.68,13473849,47.75,13216927,256922
2022-03-10 01:57:00,82.08,27966775,48.68,13494369,47.76,13238566,255803
2022-03-10 01:58:00,82.14,27987042,48.68,13504188,47.76,13248006,256182
2022-03-10 01:58:00,82.26,28028198,48.68,13523591,47.76,13268254,255337
2022-03-10 01:59:00,82.36,28062177,48.68,13541111,47.75,13282951,258160
2022-03-10 01:59:00,82.45,28090232,48.68,13554765,47.75,13296185,258580
2022-03-10 02:00:00,82.53,28117986,48.69,13569491,47.75,13307676,261815
2022-03-10 02:01:00,82.77,28202521,48.68,13609076,47.75,13348715,260361
2022-03-10 02:02:00,82.94,28260129,48.67,13634023,47.76,13378557,255466
2022-03-10 02:02:00,83.02,28284597,48.68,13647104,47.76,13388722,258382
2022-03-10 02:03:00,83.14,28327189,48.67,13666258,47.76,13410260,255998
2022-03-10 02:03:00,83.18,28341331,48.67,13673417,47.76,13416514,256903
2022-03-10 02:03:00,83.28,28373324,48.67,13688998,47.76,13431476,257522
2022-03-10 02:04:00,83.43,28427040,48.67,13713235,47.76,13457919,255316
2022-03-10 02:05:00,83.57,28472427,48.66,13732183,47.77,13482621,249562
2022-03-10 02:05:00,83.75,28533098,48.65,13760412,47.77,13511758,248654
2022-03-10 02:06:00,83.82,28559229,48.65,13772084,47.78,13525160,246924
2022-03-10 02:06:00,83.88,28579762,48.65,13782120,47.78,13534719,247401
2022-03-10 02:07:00,83.94,28601103,48.65,13792469,47.78,13544698,247771
2022-03-10 02:07:00,84.15,28670498,48.66,13829655,47.76,13573276,256379
2022-03-10 02:08:00,84.2,28688552,48.67,13838330,47.76,13581694,256636
2022-03-10 02:08:00,84.26,28707185,48.67,13848594,47.76,13589205,259389
2022-03-10 02:08:00,84.3,28720961,48.67,13855791,47.76,13595113,260678
2022-03-10 02:09:00,84.35,28739300,48.67,13863942,47.76,13604489,259453
2022-03-10 02:09:00,84.47,28780897,48.66,13881645,47.77,13626217,255428
2022-03-10 02:10:00,84.56,28811684,48.67,13898145,47.76,13638993,259152
2022-03-10 02:10:00,84.66,28845592,48.65,13910580,47.77,13658764,251816
2022-03-10 02:11:00,84.72,28866143,48.65,13920250,47.77,13668395,251855
2022-03-10 02:11:00,84.82,28900025,48.65,13937053,47.77,13683809,253244
2022-03-10 02:12:00,84.88,28918315,48.66,13946235,47.77,13692103,254132
2022-03-10 02:12:00,85.0,28960641,48.64,13962945,47.78,13715736,247209
2022-03-10 02:13:00,85.09,28991891,48.64,13977068,47.78,13731398,245670
2022-03-10 02:13:00,85.19,29025202,48.64,13993130,47.78,13747036,246094
2022-03-10 02:14:00,85.39,29094153,48.64,14027212,47.78,13778647,248565
2022-03-10 02:14:00,85.48,29124668,48.64,14042098,47.78,13792518,249580
2022-03-10 02:15:00,85.65,29181566,48.64,14069705,47.78,13819209,250496
2022-03-10 02:15:00,85.75,29215035,48.64,14085649,47.78,13834981,250668
2022-03-10 02:16:00,85.87,29257415,48.65,14108887,47.77,13851970,256917
2022-03-10 02:16:00,85.95,29285211,48.65,14122597,47.76,13864495,258102
2022-03-10 02:17:00,85.98,29294483,48.65,14127215,47.76,13868782,258433
2022-03-10 02:17:00,86.04,29313497,48.65,14135916,47.77,13878131,257785
2022-03-10 02:18:00,86.14,29349585,48.66,14154847,47.76,13893685,261162
2022-03-10 02:18:00,86.24,29384059,48.66,14173159,47.75,13907855,265304
2022-03-10 02:19:00,86.33,29414347,48.65,14183574,47.77,13926504,257070
2022-03-10 02:19:00,86.42,29444941,48.65,14198899,47.77,13940286,258613
2022-03-10 02:20:00,86.57,29496578,48.65,14223900,47.77,13964781,259119
2022-03-10 02:20:00,86.65,29521236,48.65,14235255,47.77,13976672,258583
2022-03-10 02:21:00,86.76,29560791,48.64,14251001,47.78,13998668,252333
2022-03-10 02:21:00,86.81,29577035,48.64,14258654,47.78,14006274,252380
2022-03-10 02:22:00,87.02,29649667,48.64,14295060,47.77,14038640,256420
2022-03-10 02:22:00,87.16,29695531,48.63,14312426,47.79,14064939,247487
2022-03-10 02:22:00,87.18,29703038,48.63,14316387,47.78,14067966,248421
2022-03-10 02:23:00,87.38,29772159,48.62,14347636,47.79,14102786,244850
2022-03-10 02:24:00,87.44,29790709,48.62,14356566,47.79,14111557,245009
2022-03-10 02:24:00,87.66,29868312,48.62,14394413,47.79,14147073,247340
2022-03-10 02:25:00,87.78,29908842,48.63,14416149,47.78,14164123,252026
2022-03-10 02:25:00,87.81,29917056,48.63,14419898,47.78,14168279,251619
2022-03-10 02:25:00,88.0,29981917,48.62,14448942,47.79,14201501,247441
2022-03-10 02:26:00,88.01,29986284,48.62,14450971,47.79,14203616,247355
2022-03-10 02:26:00,88.1,30015377,48.62,14464033,47.79,14218142,245891
2022-03-10 02:27:00,88.28,30079098,48.64,14499684,47.78,14243269,256415
2022-03-10 02:27:00,88.33,30093640,48.64,14507805,47.77,14248785,259020
2022-03-10 02:28:00,88.4,30118545,48.63,14517865,47.78,14262828,255037
2022-03-10 02:28:00,88.42,30127454,48.64,14523426,47.77,14265738,257688
2022-03-10 02:29:00,88.47,30142232,48.64,14530650,47.77,14272354,258296
2022-03-10 02:29:00,88.59,30183013,48.64,14550965,47.77,14290700,260265
2022-03-10 02:30:00,88.63,30196207,48.64,14558000,47.77,14296198,261802
2022-03-10 02:30:00,88.73,30231285,48.64,14574071,47.77,14313715,260356
2022-03-10 02:31:00,88.78,30249432,48.63,14579818,47.78,14325456,254362
2022-03-10 02:31:00,88.88,30282497,48.64,14597669,47.77,14339358,258311
2022-03-10 02:32:00,88.95,30307984,48.64,14610873,47.77,14350517,260356
2022-03-10 02:32:00,89.03,30332449,48.64,14622955,47.77,14361523,261432
2022-03-10 02:33:00,89.08,30350562,48.64,14632758,47.77,14368651,264107
2022-03-10 02:33:00,89.09,30354230,48.65,14634926,47.76,14369964,264962
2022-03-10 02:34:00,89.16,30376803,48.65,14646790,47.76,14379608,267182
2022-03-10 02:34:00,89.2,30392109,48.65,14654292,47.76,14386374,267918
2022-03-10 02:35:00,89.24,30405282,48.64,14658721,47.77,14394610,264111
2022-03-10 02:35:00,89.3,30425401,48.64,14668124,47.77,14404370,263754
2022-03-10 02:36:00,89.5,30495536,48.61,14690854,47.81,14449247,241607
2022-03-10 02:36:00,89.55,30511136,48.6,14697861,47.81,14457079,240782
2022-03-10 02:36:00,89.69,30557697,48.57,14710875,47.84,14488800,222075
2022-03-10 02:37:00,89.79,30591296,48.59,14732638,47.82,14498951,233687
2022-03-10 02:38:00,89.88,30624618,48.59,14747658,47.82,14515394,232264
2022-03-10 02:38:00,90.02,30671804,48.61,14777663,47.8,14530234,247429
2022-03-10 02:39:00,90.19,30728853,48.61,14804458,47.8,14557833,246625
2022-03-10 02:39:00,90.23,30742409,48.61,14811097,47.8,14564109,246988
2022-03-10 02:39:00,90.27,30756576,48.61,14819581,47.79,14569173,250408
2022-03-10 02:40:00,90.39,30795741,48.61,14836943,47.8,14588994,247949
2022-03-10 02:41:00,90.43,30811305,48.62,14846668,47.79,14593931,252737
2022-03-10 02:41:00,90.51,30839293,48.62,14862020,47.78,14605244,256776
2022-03-10 02:42:00,90.55,30851707,48.63,14868903,47.78,14609965,258938
2022-03-10 02:43:00,90.71,30906766,48.64,14900119,47.76,14631199,268920
2022-03-10 02:43:00,90.74,30914965,48.64,14903796,47.76,14635385,268411
2022-03-10 02:43:00,90.83,30948645,48.65,14923285,47.75,14648033,275252
2022-03-10 02:44:00,90.86,30956001,48.65,14927860,47.75,14650483,277377
2022-03-10 02:44:00,90.97,30995943,48.65,14947106,47.75,14669154,277952
2022-03-10 02:45:00,91.06,31025093,48.65,14960889,47.75,14683000,277889
2022-03-10 02:46:00,91.13,31048333,48.65,14970557,47.76,14695676,274881
2022-03-10 02:46:00,91.16,31058336,48.65,14976979,47.75,14698915,278064
2022-03-10 02:47:00,91.33,31117393,48.62,14993994,47.79,14738215,255779
2022-03-10 02:47:00,91.39,31137882,48.62,15005748,47.78,14745653,260095
2022-03-10 02:48:00,91.43,31151552,48.62,15012805,47.78,14751555,261250
2022-03-10 02:48:00,91.52,31181081,48.63,15027629,47.78,14764653,262976
2022-03-10 02:49:00,91.55,31193591,48.63,15033639,47.78,14770706,262933
2022-03-10 02:49:00,91.62,31216998,48.63,15047393,47.77,14779222,268171
2022-03-10 02:50:00,91.64,31224048,48.64,15051790,47.76,14781547,270243
2022-03-10 02:50:00,91.66,31229590,48.64,15054711,47.76,14783937,270774
2022-03-10 02:51:00,91.67,31234544,48.64,15058459,47.76,14784933,273526
2022-03-10 02:51:00,91.68,31238345,48.64,15060613,47.76,14786387,274226
2022-03-10 02:52:00,91.7,31244366,48.65,15064094,47.76,14788635,275459
2022-03-10 02:52:00,91.75,31259487,48.65,15071215,47.76,14795968,275247
2022-03-10 02:53:00,91.97,31335515,48.64,15104811,47.77,14834291,270520
2022-03-10 02:53:00,91.98,31337251,48.64,15105625,47.77,14835128,270497
2022-03-10 02:53:00,91.98,31338980,48.64,15106712,47.76,14835666,271046
2022-03-10 02:54:00,92.01,31349092,48.64,15111958,47.76,14840012,271946
2022-03-10 02:55:00,92.06,31366810,48.64,15119737,47.76,14848749,270988
2022-03-10 02:55:00,92.14,31394379,48.63,15132330,47.77,14862620,269710
2022-03-10 02:56:00,92.18,31408534,48.63,15139187,47.77,14869233,269954
2022-03-10 02:57:00,92.27,31437174,48.64,15155014,47.76,14880629,274385
2022-03-10 02:57:00,92.29,31444887,48.64,15158692,47.76,14884332,274360
2022-03-10 02:58:00,92.33,31457536,48.64,15163481,47.76,14891701,271780
2022-03-10 02:58:00,92.35,31465061,48.64,15167161,47.76,14895179,271982
2022-03-10 02:58:00,92.35,31466265,48.64,15167778,47.76,14895681,272097
2022-03-10 02:59:00,92.56,31536119,48.63,15200164,47.77,14930146,270018
2022-03-10 03:00:00,92.7,31585857,48.63,15223979,47.77,14953742,270237
2022-03-10 03:00:00,92.72,31591022,48.63,15227098,47.77,14955518,271580
2022-03-10 03:01:00,92.83,31627929,48.63,15245124,47.76,14972167,272957
2022-03-10 03:01:00,92.84,31631817,48.63,15247010,47.76,14973970,273040
2022-03-10 03:02:00,92.89,31649047,48.63,15255245,47.76,14982304,272941
2022-03-10 03:02:00,92.91,31654144,48.63,15257801,47.76,14984562,273239
2022-03-10 03:03:00,92.93,31664183,48.64,15262950,47.76,14988953,273997
2022-03-10 03:03:00,92.94,31665899,48.64,15264282,47.76,14989267,275015
2022-03-10 03:04:00,92.95,31669766,48.64,15266058,47.76,14991131,274927
2022-03-10 03:04:00,93.0,31684847,48.65,15277062,47.75,14994615,282447
2022-03-10 03:05:00,93.1,31719648,48.62,15284140,47.78,15020850,263290
2022-03-10 03:05:00,93.19,31751858,48.61,15298151,47.78,15037411,260740
2022-03-10 03:06:00,93.22,31760697,48.62,15303018,47.78,15040955,262063
2022-03-10 03:06:00,93.24,31767512,48.61,15305679,47.78,15044891,260788
2022-03-10 03:07:00,93.27,31778316,48.61,15311090,47.78,15049601,261489
2022-03-10 03:07:00,93.28,31783430,48.61,15313625,47.78,15051932,261693
2022-03-10 03:08:00,93.29,31784819,48.62,15314654,47.78,15052225,262429
2022-03-10 03:08:00,93.3,31789920,48.62,15317205,47.78,15054517,262688
2022-03-10 03:09:00,93.36,31807599,48.61,15324594,47.79,15063965,260629
2022-03-10 03:09:00,93.37,31811382,48.61,15326788,47.78,15065358,261430
2022-03-10 03:10:00,93.44,31835631,48.61,15337746,47.79,15077471,260275
2022-03-10 03:10:00,93.53,31868022,48.58,15344652,47.81,15101705,242947
2022-03-10 03:10:00,93.56,31876156,48.58,15348172,47.82,15105997,242175
2022-03-10 03:11:00,93.69,31920979,48.56,15363588,47.83,15133143,230445
2022-03-10 03:12:00,93.81,31961274,48.55,15380122,47.84,15154768,225354
2022-03-10 03:13:00,93.83,31968393,48.56,15384316,47.84,15157365,226951
2022-03-10 03:13:00,93.84,31971094,48.56,15386061,47.84,15158173,227888
2022-03-10 03:13:00,93.84,31972314,48.56,15386563,47.84,15158828,227735
2022-03-10 03:15:00,93.92,31999027,48.55,15398384,47.84,15172293,226091
2022-03-10 03:15:00,93.94,32006456,48.56,15404039,47.83,15173851,230188
2022-03-10 03:16:00,93.94,32008138,48.56,15404959,47.83,15174514,230445
2022-03-10 03:17:00,93.95,32009551,48.56,15405993,47.83,15174847,231146
2022-03-10 03:17:00,94.02,32034841,48.56,15418731,47.83,15186092,232639
2022-03-10 03:17:00,94.11,32065731,48.56,15432466,47.83,15201761,230705
2022-03-10 03:18:00,94.15,32077705,48.56,15437952,47.84,15207873,230079
2022-03-10 03:18:00,94.19,32091824,48.56,15444806,47.83,15214109,230697
2022-03-10 03:19:00,94.26,32115864,48.56,15456543,47.83,15225364,231179
2022-03-10 03:19:00,94.28,32123633,48.56,15460689,47.83,15228623,232066
2022-03-10 03:20:00,94.3,32129737,48.56,15463935,47.83,15231167,232768
2022-03-10 03:20:00,94.3,32130058,48.56,15464041,47.83,15231302,232739
2022-03-10 03:21:00,94.33,32139174,48.56,15469005,47.83,15234984,234021
2022-03-10 03:21:00,94.34,32141417,48.57,15470482,47.83,15235639,234843
2022-03-10 03:22:00,94.38,32157944,48.56,15478209,47.83,15243564,234645
2022-03-10 03:22:00,94.51,32201086,48.56,15498970,47.83,15263868,235102
2022-03-10 03:23:00,94.54,32211851,48.57,15505302,47.82,15267815,237487
2022-03-10 03:23:00,94.55,32215505,48.57,15507845,47.82,15268725,239120
2022-03-10 03:24:00,94.59,32229636,48.57,15513600,47.83,15276618,236982
2022-03-10 03:24:00,94.62,32239940,48.57,15519256,47.82,15280896,238360
2022-03-10 03:25:00,94.7,32265240,48.57,15531642,47.82,15292829,238813
2022-03-10 03:25:00,94.72,32273272,48.56,15533213,47.83,15299032,234181
2022-03-10 03:26:00,94.77,32290674,48.56,15540426,47.83,15308631,231795
2022-03-10 03:27:00,95.07,32392333,48.56,15588158,47.84,15357558,230600
2022-03-10 03:27:00,95.11,32404262,48.56,15595755,47.83,15361546,234209
2022-03-10 03:28:00,95.2,32437064,48.56,15610295,47.84,15378111,232184
2022-03-10 03:28:00,95.22,32443737,48.56,15614280,47.83,15380380,233900
2022-03-10 03:29:00,95.24,32449877,48.56,15618079,47.83,15382432,235647
2022-03-10 03:29:00,95.29,32468264,48.56,15624908,47.84,15393316,231592
2022-03-10 03:30:00,95.32,32476778,48.56,15628912,47.84,15397494,231418
2022-03-10 03:30:00,95.37,32493543,48.56,15639673,47.83,15402565,237108
2022-03-10 03:31:00,95.47,32528580,48.57,15658111,47.82,15417418,240693
2022-03-10 03:31:00,95.49,32534961,48.57,15661524,47.82,15420134,241390
2022-03-10 03:32:00,95.61,32574398,48.57,15681240,47.82,15437970,243270
2022-03-10 03:32:00,95.61,32575857,48.57,15681895,47.82,15438697,243198
2022-03-10 03:33:00,95.64,32587174,48.58,15688722,47.81,15442760,245962
2022-03-10 03:33:00,95.89,32671533,48.58,15732010,47.81,15479973,252037
2022-03-10 03:34:00,95.91,32676398,48.59,15735269,47.8,15481366,253903
2022-03-10 03:34:00,95.91,32678239,48.59,15736346,47.8,15482051,254295
2022-03-10 03:35:00,96.02,32713757,48.6,15756292,47.79,15495990,260302
2022-03-10 03:36:00,96.14,32756197,48.6,15776361,47.79,15516294,260067
2022-03-10 03:36:00,96.18,32771332,48.61,15786807,47.79,15520447,266360
2022-03-10 03:37:00,96.21,32781613,48.6,15790945,47.79,15526153,264792
2022-03-10 03:37:00,96.22,32783818,48.6,15792447,47.79,15526772,265675
2022-03-10 03:38:00,96.31,32815533,48.6,15806765,47.79,15542521,264244
2022-03-10 03:38:00,96.43,32855127,48.57,15816765,47.82,15570686,246079
2022-03-10 03:39:00,96.43,32856586,48.57,15817835,47.82,15571015,246820
2022-03-10 03:39:00,96.49,32874047,48.58,15827905,47.81,15577665,250240
2022-03-10 03:40:00,96.49,32875500,48.58,15828857,47.81,15578102,250755
2022-03-10 03:40:00,96.6,32914257,48.58,15846767,47.81,15596767,250000
2022-03-10 03:41:00,96.61,32917334,48.58,15848231,47.81,15598229,250002
2022-03-10 03:41:00,96.73,32956495,48.58,15866464,47.81,15617157,249307
2022-03-10 03:42:00,96.73,32958458,48.58,15867791,47.81,15617713,250078
2022-03-10 03:42:00,96.74,32960293,48.58,15868615,47.81,15618643,249972
2022-03-10 03:43:00,96.89,33013312,48.58,15894190,47.81,15643137,251053
2022-03-10 03:43:00,96.94,33029523,48.58,15901695,47.81,15651364,250331
2022-03-10 03:44:00,96.95,33032284,48.58,15902554,47.81,15653109,249445
2022-03-10 03:44:00,96.97,33037469,48.58,15905039,47.81,15655473,249566
2022-03-10 03:45:00,97.04,33063175,48.58,15917959,47.81,15667019,250940
2022-03-10 03:45:00,97.06,33068672,48.58,15920484,47.81,15669714,250770
2022-03-10 03:46:00,97.06,33069566,48.58,15920854,47.81,15670082,250772
2022-03-10 03:47:00,97.25,33135935,48.57,15949830,47.82,15704202,245628
2022-03-10 03:47:00,97.27,33140393,48.57,15951845,47.82,15706412,245433
2022-03-10 03:48:00,97.27,33140392,48.57,15951845,47.82,15706412,245433
2022-03-10 03:49:00,97.27,33141905,48.57,15953017,47.82,15706703,246314
2022-03-10 03:49:00,97.28,33143447,48.57,15953998,47.82,15707215,246783
2022-03-10 03:50:00,97.67,33279178,48.59,16027679,47.79,15762420,265259
2022-03-10 03:50:00,97.77,33312577,48.59,16041588,47.8,15780255,261333
2022-03-10 03:51:00,97.78,33314069,48.59,16042457,47.8,15780786,261671
2022-03-10 03:52:00,97.83,33332505,48.58,16049357,47.8,15791776,257581
2022-03-10 03:52:00,97.84,33334243,48.58,16050698,47.8,15792104,258594
2022-03-10 03:52:00,97.94,33368292,48.58,16066656,47.8,15808558,258098
2022-03-10 03:53:00,97.94,33370439,48.58,16068141,47.8,15809126,259015
2022-03-10 03:54:00,97.94,33370441,48.58,16068142,47.8,15809127,259015
2022-03-10 03:54:00,97.95,33374554,48.58,16070310,47.8,15810883,259427
2022-03-10 03:56:00,97.97,33379719,48.59,16073461,47.8,15812692,260769
2022-03-10 03:57:00,97.97,33381054,48.59,16074346,47.8,15813091,261255
2022-03-10 03:58:00,97.98,33382958,48.59,16075656,47.8,15813617,262039
2022-03-10 03:58:00,97.99,33385934,48.59,16077430,47.8,15814695,262735
2022-03-10 03:59:00,97.99,33386925,48.59,16077818,47.8,15815220,262598
2022-03-10 04:00:00,98.02,33397975,48.59,16084199,47.79,15819577,264622
2022-03-10 04:00:00,98.13,33432563,48.59,16099594,47.8,15836910,262684
2022-03-10 04:01:00,98.13,33434073,48.59,16100724,47.79,15837228,263496
2022-03-10 04:01:00,98.14,33437766,48.59,16102992,47.79,15838500,264492
2022-03-10 04:03:00,98.15,33440227,48.59,16103984,47.79,15839779,264205
2022-03-10 04:07:00,98.15,33441649,48.59,16104570,47.79,15840534,264036
2022-03-10 04:08:00,98.16,33443091,48.59,16105100,47.79,15841371,263729
2022-03-10 04:10:00,98.2,33459566,48.59,16111875,47.8,15850227,261648
2022-03-10 04:10:00,98.32,33498975,48.58,16130199,47.8,15869282,260917
2022-03-10 04:11:00,98.33,33501096,48.58,16131035,47.8,15870444,260591
2022-03-10 04:13:00,98.34,33506123,48.58,16132976,47.8,15873332,259644
2022-03-10 04:15:00,98.34,33507311,48.58,16133693,47.8,15873740,259953
2022-03-10 04:15:00,98.34,33507319,48.58,16133698,47.8,15873742,259956
2022-03-10 04:16:00,98.44,33540234,48.58,16148980,47.8,15889826,259154
2022-03-10 04:20:00,98.54,33573779,48.6,16172994,47.78,15897987,275007
2022-03-10 04:21:00,98.54,33575224,48.6,16173610,47.78,15898745,274865
2022-03-10 04:22:00,98.57,33582488,48.6,16176560,47.78,15902841,273719
2022-03-10 04:23:00,98.57,33583801,48.6,16177161,47.78,15903479,273682
2022-03-10 04:23:00,98.58,33587988,48.6,16179156,47.78,15905520,273636
2022-03-10 04:25:00,98.67,33617159,48.6,16193656,47.78,15918324,275332
2022-03-10 04:25:00,98.67,33617160,48.6,16193656,47.78,15918325,275331
2022-03-10 04:26:00,98.76,33647240,48.6,16208074,47.78,15932924,275150
2022-03-10 04:26:00,98.76,33649187,48.61,16209710,47.78,15933196,276514
2022-03-10 04:27:00,98.94,33709043,48.6,16237108,47.78,15962942,274166
2022-03-10 04:27:00,98.94,33709046,48.6,16237110,47.78,15962943,274167
2022-03-10 04:29:00,98.94,33709048,48.6,16237110,47.78,15962945,274165
2022-03-10 04:30:00,98.96,33716951,48.61,16242935,47.78,15964764,278171
2022-03-10 04:32:00,99.03,33740426,48.6,16252304,47.78,15978153,274151
2022-03-10 04:32:00,99.03,33740429,48.6,16252306,47.78,15978154,274152
2022-03-10 04:34:00,99.03,33740425,48.6,16252306,47.78,15978150,274156
2022-03-10 04:35:00,99.14,33778613,48.59,16267963,47.79,15998739,269224
2022-03-10 04:35:00,99.14,33778617,48.59,16267965,47.79,15998741,269224
2022-03-10 04:37:00,99.21,33802198,48.59,16278145,47.79,16011124,267021
2022-03-10 04:37:00,99.22,33805912,48.59,16279874,47.79,16012749,267125
2022-03-10 04:39:00,99.22,33805914,48.59,16279874,47.79,16012751,267123
2022-03-10 04:41:00,99.24,33812597,48.59,16283070,47.79,16015852,267218
2022-03-10 04:41:00,99.24,33812746,48.59,16283116,47.79,16015963,267153
2022-03-10 04:45:00,99.25,33815023,48.59,16283116,47.79,16015964,267152
2022-03-10 04:51:00,99.26,33819197,48.59,16285862,47.79,16018906,266956
2022-03-10 04:59:00,99.36,33852298,48.58,16299461,47.8,16037078,262383
2022-03-10 04:59:00,99.46,33886851,48.59,16318977,47.79,16050818,268159
2022-03-10 05:01:00,99.49,33896611,48.59,16322937,47.79,16056167,266770
2022-03-10 05:02:00,99.49,33896616,48.59,16322941,47.79,16056167,266774
2022-03-10 05:05:00,99.49,33896631,48.59,16322946,47.79,16056176,266770
2022-03-10 05:05:00,99.49,33896997,48.59,16323163,47.79,16056283,266880
2022-03-10 05:11:00,99.49,33897001,48.59,16323166,47.79,16056283,266883
2022-03-10 05:18:00,99.64,33947650,48.58,16343547,47.81,16083958,259589
2022-03-10 05:21:00,99.64,33947653,48.58,16343548,47.81,16083960,259588
2022-03-10 05:23:00,99.79,33998947,48.57,16365562,47.81,16110945,254617
2022-03-10 05:44:00,99.79,34000701,48.57,16366380,47.81,16111810,254570
2022-03-10 05:45:00,99.88,34031733,48.56,16379143,47.82,16129128,250015
2022-03-10 05:48:00,99.89,34033465,48.56,16379983,47.82,16129960,250023
2022-03-10 05:49:00,99.89,34033477,48.56,16379990,47.82,16129964,250026
2022-03-10 05:52:00,99.9,34037126,48.56,16382124,47.82,16131312,250812
2022-03-10 06:02:00,99.99,34067853,48.56,16394815,47.83,16147738,247077
